-----Given a 11x15 maze-----
Marking the positions using '*' for the path in the maze
1 1 1 1 1 1 1 1 1 1 1 1 1 1 1 1 1 
1 s 1 * * * 1 1 * * * 1 1 1 1 1 1 
1 1 * 0 * 1 1 * 1 1 1 * * 1 1 1 1 
1 0 1 1 * * * * 1 1 1 1 * * 1 1 1 
1 1 1 * 1 1 1 1 * 1 1 0 1 1 * 0 1 
1 1 1 * 1 0 0 1 * 1 1 1 1 1 1 1 1 
1 0 * 1 1 0 1 1 1 0 1 0 0 1 0 1 1 
1 * 1 1 1 1 * * 1 1 1 1 1 1 1 1 1 
1 0 * 1 1 * 1 1 * 1 1 1 1 1 * 1 1 
1 1 1 * * 0 1 1 * 1 1 * * * 0 * 1 
1 0 0 1 1 1 1 1 0 * * 1 1 1 1 * 1 
1 0 1 0 0 1 1 1 1 1 0 1 1 1 1 d 1 
1 1 1 1 1 1 1 1 1 1 1 1 1 1 1 1 1 
